14
XXXXXXXEXXXXXXX
XOOOOOOOOOOOOOX
XCCOOOOOKOOOOOX
XQQQXXOSCOOOOOX
XOOOOOOOOOOOOOX
XXOOHQHOOOOOOOX
XOOOHPHOOOOOOOX
XOOOOOOOOOOOOOX
XOOOOOOOOOOOOOX
XOOOOOOOOOOOOOX
XOOOOOOOOOOOOOX
XOOOOOOOOOOOOOX
XOOOOOOOOOOOOOX
XXXXXXXXXXXXXXX