28
SOOOOOOOOOOOOOOOOOOOOOOOOOOOOOOOOOOOOOOOOOX
XXXXXXXXXXXXXXXXXXXXXXXXXXXXXXXXXXXXXXXXXOX
XOOOOOOOOOOOOOOOOOOOOOOOOOOOOOOOOOOOOOOOXOX
XOOOOOOOOOOOOOOOOOOOOOOOOOOOOOOOOOOOOOOOXOX
XOOOOOOOOOOOOOOOOOOOOOOOOOOOOOOOOOOOOOOOXOX
XOOOOOOOOOOOOOOOOOOOOOOOOOOOOOOOOOOOOOOOXOX
XOOOOOOOOOOOOOOOOOOOOOOOOOOOOOOOOOOOOOQXXOX
XOOOOOOOOOOOOOOOOOOOOOOOOOOOOOOOOOOOOOXEXOX
XOXXXXXXXXXXXXXXXXXXXXXXXXXXXXXXXXXXXXXXXOX
XOOOOOOOOOOOOOOOOOOOOOOOOOOOOOOOOOOOOOOOOOX
XOXXXXXXXXXXXXXXXXXXXXXXXXXXXXXXXXXXXXXXXOX
XOOOOOOOOOOOOOOOOOOOOOOOOOOOOOOOOOOOOOOOXOX
XOOOOOOOOOOOOOOOOOOOOOOOOOOOOOOOOOOOOOOOXOX
XOOOOOOOOOOOOOOOOOOOOOOOOOOOOOOOOOOOOOOOXOX
XOOOOOOOOOOOOOOOOOOOOOOOOOOOOOOOOOOOOOOOXOX
XOOOOOOOOOOOOOOOOOOOOOOOOOOOOOOOOOOOOOXQXOX
XOOOOOOOOOOOOOOOOOOOOOOOOOOOOOOOOOOOOOXEXOX
XXXXXXXXXXXXXXXXXXXXXXXXXXXXXXXXXXXXXXXXXOX
XOOOOOOOOOOOOOOOOOOOOOOOOOOOOOOOOOOOOOOOXOX
XOXOOOOOOOOOOOOOOOOOOOOOOOOOOOOOOOOOOOOOXOX
XOXOOOOOOOOOOOOOOOOOOOOOOOOOOOOOOOOOOOOOXOX
XOXOOOOOOOOOOOOOOOOOOOOOOOOOOOOOOOOOAAOOXOX
XOXOOOOOOOOOOOOOOOOOOOOOOOOOOOOOOOOOACOOXOX
XOXOOOOOOOOOOOOOOOOOOOOOOOOOOOOOOOOXAAXXXOX
XOXOOOOOOOOOOOOOOOOOOOOOOOOOOOOOOOOXOOQEXOX
XOXXXXXXXXXXXXXXXXXXXXXXXXXXXXXXXXXXXXXXXOX
XOOOOOOOOOOOOOOOOOOOOOOOOOOOOOOOOOOOOOOOOOX
XXXXXXXXXXXXXXXXXXXXXXXXXXXXXXXXXXXXXXXXXXX