22
XXXXXXXXXXXXXEXXX
XHHHHHHHHHHHHHHOX
XOOOHOOOHHHHHHHHX
XOOOHOOAAOHHHHOOX
XHHHHHHHHHHHHHHHX
XOOOOOOOOOOOOOOOX
XOOOOOOOOOEOOOOOX
XHHHHHHHHHHHHHHHX
XHHHHHHHHHHHHHHHX
XOOOOOEOOOEOOOOOX
XOOOOOOOOOOOOOOOX
XXXXQQQQQQQQQXXXX
XOOOOOOOOOOOOOOOX
XOOOOOCOOOOOOOOOX
XOQQQQQQQQOAOOOOX
XOOOOOSOOOOAOOOOX
XOOXOOOOOOEOOOOOX
XOOXOOPPPOOOOOOOX
XOOXOOOOOOOOOOOOX
XOOOOHHHHHHHHHHOX
XHHHHHHHHHHHHOOOX
XXXXXXXXXXXXXXXXX