8
XXXXXXXEXX
XOOOOOOOOX
XCCOOOOOKX
XQQQXXOSCX
XOOOOOOOOX
XXOOHQHOOX
XOOOHPHOOX
XXXXXXXXXX