26
XXXXXXXXXXXXXXXXXXXXXXXXXXXXXXXXXXXXXXXX
XOAAAOOCCCOOOOOOCCCCCOOOOOOOOOOCACOOOOOX
XOAAAOOOOOOOOOOOCAAACOOOOOOOOOOCACOOOOOX
XOOOOQCCCOOOOOOOCAAACOOOOCCCCOOCACOCCOOX
XOAAAOOOOOOOOOOOCAAACOOOOOOOOOOCACOCCOOX
XOAAAOAAAAAAAAAACCCCCOOOOOOAAXAAAOOCCOOX
XOOOOXOOOOCCOOOOAOOOOOOOOOOAOCCOAOOCCCOX
XOAAAOOOOOCCOOOOAOOOOOOOOOOAAQAAAOOOOOOX
XOAAAOOOOXXXXXXXXXQQQQXXXXXAOOOOOOOOOOOX
XOOOOQOOOXOOOOOOOOOOOOOOOOOOOOOOOOOOOOOX
XOAAAOXXXXXXXXXQXXXXXXXQXXXXXXXXQXXXXXXX
XSOOOXOOOOOXOOOOOOOXOOOOOXOOOOXOOOXCCCAX
XOAAAOOOOOOXXQXXXXXXAAAAAAOOOOOXXXOXXQEX
XOPOOXOCCCCOOOOOOXCCCCCCCCCCXAAAAOOOOQXX
XOAAAOOCCQQQQQXXXXCCCCCCCCCCQQAAAAAAACCX
XOAAAOOCCCCCCCCCCCCCCCOOOOOOXAAAAOOOOOCX
XOOOOXOCCAAAAAAACCCCCCOOOOOOQAAAAOOOOOCX
XOAAAOOCCAAAAAAACCCCCCOOOOOOOXXXXCCCCCCQ
XOAAAOOCCCCCCCCCCCCCCOOOXAAAAAAAAAAAAAAQ
XOOOOQOOOOOOOOOOOOOOOOOOXAACCCCCCCCCCCCQ
XOAAAOOOCCCCOOOOOOOOOOOOCCCCCAAAAAACCCCQ
XOAAAOOOOOCCOOOOOOCCCCOOCCCCCAAAAAACCCCX
XOOOOXOCOCOCOOOOOOCCCOOOCCCCCAAAAAACCCCX
XOAAAOOOCOOCOOXXQQXXXQXOCCCCCAAAAAACXXQX
XOAAAOOCOOOCOOXXQXCCCAQOCCCCCCQQXCCCXKOX
XXXXXXXXXXXXXXXXQQQXXXXXXXXXXXXQQQXXXXXX
