26
XXXXXXXXXXXXXXXXXXXXXXXXXXXXXXXXXXXXXXXXXX
XCCCCCCCCCCCCCCCCCCCCCCCCCCCCXOOOOOOOOOOOX
XXXXXXXXXXXXXXXXXXXXXHXXXXXXXXOOOOOOOOOOOX
XOXOXOXOXOXOOOXOOXOOXOXOXOXOHXOCCCCCCOOOOX
XOXOXOXOXOXOOOXOOXOOXOXOXOXOXXOCAAAACOOOOX
XOOOOOOOOOOOOOOOOOOOOOOOOOOOOXOCCCCCCOOOOX
XXXXXXXXXXOOOOXXXXXXXXXXXXXXXXOOOOOOOOOOOX
XOHOOOXOOOOOOOOOOXCCOOOOOOOCCXOOOOOOOOOOOX
XOXXXOOXOOXXXXXCOXOOOXXXXOOOOXOOOOOOOOOOOX
XOXOCXOOXOHCCCHOOXOOOOCCOOOOOXOOOAAAAAOOOX
XOXOXXXOOOXXXXXOOXOOOXXXXOOOOXOOOCCACCOOOX
XOXOOOOOOOOOOOOOOXOOOOOOOOOOOHOOOOCACOOOOX
EOXOOXOXXXXXOXOOOXOOXXXXXXXXXXOOOOCACOOOOX
XOXCOXOOXXXOOXOOOOOOOXXOOOOOOXOOOOCACOOOOX
XXXXXXOXXXXXOXXXXXXXOXOOOXOXOXOOOOCACOOOOX
XCCOOOOOOOXOOXOOOXOOOXOXOXOXOXOOOOCACOOOOX
XXXXXXOOOOOOOOOXOOOXOOOXOXOXOXOOOOOCOOOOOX
XCOAAXXXXXXXXXXXXXXXXXXXOXOXOXOOOOOOOOOOOX
XXOXXOOXOOOOOOOOOOOOOOOXOXCXOXOOOOOOOOOOOX
XOOOOOOXOOOXOXXXXXXXXXXXOXXXOXOOOOOOOOOOOH
XXHXOOXCXOOXOOOOOOOOOOOOOOOOOXOOOOOOOOOOXH
XXHXOOOOOOOXOXOXOXAXOOOOOAAAOXXXXXOOOOOXHH
XXHXXXCCCXXXOXXXXXXXXHXXXXXXXXXXXOOOOOXXHX
XCCCCXXXXXXXOXXAOOOOOOOOOOOSOXXXOCCCOXXXHH
XCCCCXOOAAOOOOOOOAOAOXCOOAXCOXKXXXXXXHHHXH
XXXXXXXXXXXXXXXXXXXXXXXXXXXXXXHHHHHHHHXHHH
