10
XXXXXXXXXXXXXXXXXX
XOOOOOOOOOOOOOOOOX
XOOOOOOOOOOOOOOOOX
XOOOOOOOOOOOOOOOOX
XOOOOOOOSOOOOOOOOX
XOOOOOOOOOOOOOOOOX
XOOOOOOOOOOOOOOOOX
XOOOOOOOOOOOOOOOOX
XOOOOOOOOOOOOOOOOX
XXXXXXXXXXXXXXXXXX